TILEMAP
211 15 							-- Size of tile map in tiles
32 32							-- Tile size & block size
images/complete_tileset.png 	-- Tilesheet
32 32 								-- Number of tiles in tilesheet
71,71,71,71,71,71,71,71,71,71,71,71,71,71,71,71,71,71,71,71,71,71,71,71,71,71,71,71,71,71,71,71,71,71,71,71,71,71,71,71,71,71,71,71,71,71,71,71,71,71,71,71,71,71,71,71,71,71,71,71,71,71,71,71,71,71,71,71,71,71,71,71,71,71,71,71,71,71,71,71,71,71,71,71,71,71,71,71,71,71,71,71,71,71,71,71,71,71,71,71,71,71,71,71,71,71,71,71,71,71,71,71,71,71,71,71,71,71,71,71,71,71,71,71,71,71,71,71,71,71,71,71,71,71,71,71,71,71,71,71,71,71,71,71,71,71,71,71,71,71,71,71,71,71,71,71,71,71,71,71,71,71,71,71,71,71,71,71,71,71,71,71,71,71,71,71,71,71,71,71,71,71,71,71,71,71,71,71,71,71,71,71,71,71,71,71,71,71,71,71,71,71,71,71,71,71,71,71,71,71,71,
71,71,71,71,71,71,71,71,71,71,71,71,71,71,71,71,71,71,71,71,71,71,71,71,71,71,71,71,71,71,71,71,71,71,71,71,71,71,71,71,71,71,71,71,71,71,71,71,71,71,71,71,71,71,71,71,71,71,71,71,71,71,71,71,71,71,71,71,71,71,71,71,71,71,71,71,71,71,71,71,71,71,71,71,71,71,71,71,71,71,71,71,71,71,71,71,71,71,71,71,71,71,71,71,71,71,71,71,71,71,71,71,71,71,71,71,71,71,71,71,71,71,71,71,71,71,71,71,71,71,71,71,71,71,71,71,71,71,71,71,71,71,71,71,71,71,71,71,71,71,71,71,71,71,71,71,71,71,71,71,71,71,71,71,71,71,71,71,71,71,71,71,71,71,71,71,71,71,71,71,71,71,71,71,71,71,71,71,71,71,71,71,71,71,71,71,71,71,71,71,71,71,71,71,71,71,71,71,71,71,71,
71,71,71,71,71,71,71,71,71,71,71,71,71,71,71,71,71,71,71,641,642,643,71,71,71,71,71,71,71,71,71,71,71,71,71,71,641,642,642,643,71,71,71,71,71,71,71,71,71,71,71,71,71,71,71,71,71,71,71,71,71,71,71,71,71,71,71,641,642,643,71,71,71,71,71,71,71,71,71,71,71,71,71,71,641,642,642,643,71,71,71,71,71,71,71,71,71,71,71,71,71,71,71,71,71,71,71,71,71,71,71,71,71,71,71,71,71,71,71,71,71,71,71,71,71,71,71,71,71,71,71,71,641,642,642,643,71,71,71,71,71,71,71,71,71,71,71,71,71,71,71,71,71,71,71,71,71,71,71,71,71,71,71,641,642,643,71,71,71,71,71,71,71,71,71,71,71,71,71,71,641,642,642,643,71,71,71,71,71,71,71,71,71,71,71,71,71,71,329,71,71,71,71,71,71,71,71,71,71,71,71,
71,71,71,71,71,71,71,71,641,642,643,71,71,71,71,71,71,71,71,673,674,675,71,71,71,71,71,641,642,642,642,643,71,71,71,71,673,674,674,675,71,71,71,71,71,71,71,71,71,71,71,71,71,71,71,71,641,642,643,71,71,71,71,71,71,71,71,673,674,675,71,71,71,71,71,641,642,642,642,643,71,71,71,71,673,674,674,675,71,71,71,71,71,71,71,71,71,71,71,71,71,71,71,71,71,71,71,71,71,71,71,71,71,71,71,71,71,71,71,71,71,71,71,641,642,642,642,643,71,71,71,71,673,674,674,675,71,71,71,71,71,71,71,71,71,71,71,71,71,71,71,71,641,642,643,71,71,71,71,71,71,71,71,673,674,675,71,71,71,71,71,641,642,642,642,643,71,71,71,71,673,674,674,675,71,71,71,71,71,71,71,71,71,71,71,71,71,71,361,71,641,642,643,71,71,71,71,71,71,71,71,
71,71,71,71,71,71,71,71,673,674,675,71,71,71,71,71,71,71,71,71,71,71,71,71,71,71,71,673,674,674,674,675,71,71,71,71,71,71,71,71,71,71,71,71,71,71,71,71,71,71,71,71,71,71,71,71,673,674,675,71,71,71,71,71,71,71,71,71,71,71,71,71,71,71,71,673,674,674,674,675,71,71,71,71,71,71,71,71,71,71,71,71,71,71,71,71,71,71,71,71,71,71,71,71,71,71,71,71,71,71,71,71,71,71,71,71,71,71,71,71,71,71,71,673,674,674,674,675,71,71,71,71,71,71,71,71,71,71,71,71,71,71,71,71,71,71,71,71,71,71,71,71,673,674,675,71,71,71,71,71,71,71,71,71,71,71,71,71,71,71,71,673,674,674,674,675,71,71,71,71,71,71,71,71,71,71,71,71,71,71,71,71,71,71,71,71,71,71,361,71,673,674,675,71,71,71,71,71,71,71,71,
71,71,71,71,71,71,71,71,71,71,71,71,71,71,71,71,71,71,71,71,71,71,0,71,71,71,71,71,71,71,71,71,71,71,71,71,71,71,71,71,71,71,71,71,71,71,71,71,71,71,71,71,71,71,71,71,71,71,71,71,71,71,71,71,71,71,71,71,71,71,71,71,71,71,71,71,71,71,71,71,0,0,0,0,0,0,0,0,71,71,71,0,0,0,0,71,71,71,71,71,71,71,71,71,71,71,71,71,71,0,71,71,71,71,71,71,71,71,71,71,71,0,0,0,71,71,71,71,0,0,0,0,71,71,71,71,71,71,71,71,71,71,71,71,71,71,71,71,71,71,71,71,71,71,71,71,71,71,71,71,71,71,71,71,71,71,71,71,71,71,71,71,71,71,71,71,71,71,71,71,71,71,71,71,71,71,71,71,0,0,71,71,71,71,71,71,71,71,361,71,71,71,71,71,71,71,71,71,71,71,71,
71,71,71,71,71,71,71,71,71,71,71,71,71,71,71,71,71,71,71,71,71,71,71,71,71,71,71,71,71,71,71,71,71,71,71,71,71,71,71,71,71,71,71,71,71,71,71,71,71,71,71,71,71,71,71,71,71,71,71,71,71,71,71,71,71,71,71,71,71,71,71,71,71,71,71,71,71,71,71,71,71,71,71,71,71,71,71,71,71,71,71,71,71,71,71,71,71,71,71,71,71,71,71,71,71,71,71,71,71,71,71,71,71,71,71,71,71,71,71,71,71,71,71,71,71,71,71,71,71,71,71,71,71,71,71,71,71,71,71,71,71,71,71,71,71,71,71,71,71,71,71,71,71,71,71,71,71,71,71,71,71,71,71,71,71,71,71,71,71,71,71,71,71,71,71,71,71,71,71,71,71,71,71,71,71,71,71,0,0,0,71,71,71,71,71,71,71,71,361,71,71,71,71,71,71,71,71,71,71,71,71,
71,71,71,71,71,71,71,71,71,71,71,71,71,71,71,71,71,71,71,71,71,71,71,71,71,71,71,71,71,71,71,71,71,71,71,71,71,71,71,71,71,71,71,71,71,71,71,71,71,71,71,71,71,71,71,71,71,71,71,71,71,71,71,71,71,71,71,71,71,71,71,71,71,71,71,71,71,71,71,71,71,71,71,71,71,71,71,71,71,71,71,71,71,71,71,71,71,71,71,71,71,71,71,71,71,71,71,71,71,71,71,71,71,71,71,71,71,71,71,71,71,71,71,71,71,71,71,71,71,71,71,71,71,71,71,71,71,71,71,71,71,71,71,71,71,71,71,71,71,71,71,71,71,71,71,71,71,71,71,71,71,71,71,71,71,71,71,71,71,71,71,71,71,71,71,71,71,71,71,71,71,71,71,71,71,71,0,0,0,0,71,71,71,71,71,71,71,71,361,71,71,71,71,71,71,71,71,71,71,71,71,
71,71,71,71,71,71,71,71,71,71,71,71,71,71,71,71,71,71,71,71,71,71,71,71,71,71,71,71,71,71,71,71,71,71,71,71,71,71,71,71,71,71,71,71,71,71,71,71,71,71,71,71,71,71,71,71,71,71,71,71,71,71,71,71,71,71,71,71,71,71,71,71,71,71,71,71,71,71,71,71,71,71,71,71,71,71,71,71,71,71,71,71,71,71,71,71,71,71,71,71,71,71,71,71,71,71,71,71,71,71,71,71,71,71,71,71,71,71,71,71,71,71,71,71,71,71,71,71,71,71,71,71,71,71,71,71,71,71,71,71,71,71,71,71,71,71,71,71,71,71,71,71,71,71,71,71,71,71,71,71,71,71,71,71,71,71,71,71,71,71,71,71,71,71,71,71,71,71,71,71,71,71,71,71,71,0,0,0,0,0,71,71,71,71,71,71,71,71,361,71,71,71,71,5,5,5,71,71,71,71,71,
71,71,71,71,71,71,71,71,71,71,71,71,71,71,71,71,71,71,71,71,0,0,0,0,0,71,71,71,71,71,71,71,71,71,71,71,71,71,71,71,71,71,71,71,71,71,0,0,71,71,71,71,71,71,71,71,71,0,0,71,71,71,71,71,71,71,71,71,71,71,71,71,71,71,71,71,71,0,0,0,71,71,71,71,71,71,71,71,71,71,71,71,71,71,0,71,71,71,71,71,0,0,71,71,71,71,0,71,71,0,71,71,0,71,71,71,71,71,0,71,71,71,71,71,71,71,71,71,71,0,0,71,71,71,71,71,71,0,71,71,0,71,71,71,71,71,71,71,71,71,71,0,0,71,71,0,71,71,71,71,71,71,71,71,71,71,71,71,0,0,0,0,71,71,71,71,71,71,71,71,71,71,71,71,0,0,0,0,0,0,71,71,71,71,71,71,71,71,361,71,71,71,71,36,37,38,71,71,71,71,71,
71,71,323,71,71,71,71,71,71,71,71,71,71,71,71,71,71,71,71,71,71,71,71,71,71,71,71,71,71,71,71,71,71,71,71,71,71,71,0,0,71,71,71,71,71,71,0,0,71,71,323,71,71,71,71,71,71,0,0,71,71,71,71,71,71,71,71,71,71,71,71,71,71,71,71,71,71,71,71,71,71,71,71,71,71,71,71,71,71,71,71,71,71,71,71,71,71,71,323,71,71,71,71,71,71,71,71,71,71,71,71,71,71,71,71,71,71,71,71,71,71,71,71,71,71,71,71,71,71,71,71,71,71,71,71,71,0,0,71,71,0,0,71,71,71,71,323,71,71,71,0,0,0,71,71,0,0,71,71,71,71,71,71,71,71,71,71,71,71,71,71,71,71,71,71,71,71,71,71,71,71,71,71,0,0,0,0,0,0,0,71,71,71,71,323,71,71,71,361,71,71,71,5,6,6,6,5,71,71,71,71,
71,353,354,357,71,71,71,71,71,71,71,71,71,71,71,71,71,323,71,71,71,71,71,71,71,71,71,71,0,0,71,71,71,71,71,71,71,71,0,0,71,71,71,71,71,71,0,0,71,353,354,357,71,71,71,71,71,0,0,71,71,71,71,71,71,323,71,71,71,71,71,71,71,71,71,71,71,71,71,71,71,71,71,71,71,71,71,71,71,71,71,71,71,71,71,71,71,353,354,357,71,71,71,71,71,71,71,71,71,71,71,71,71,323,71,71,71,71,71,71,71,71,71,71,71,71,71,71,71,71,71,71,71,71,71,0,0,0,71,71,0,0,0,71,71,353,354,357,71,0,0,0,0,71,71,0,0,0,71,71,71,323,71,0,0,71,71,71,71,71,71,71,71,71,71,71,71,71,71,0,0,71,0,0,0,0,0,0,0,0,71,71,71,353,354,357,71,71,361,71,71,71,3,37,7,3,37,71,71,323,71,
353,354,355,356,357,71,71,71,71,71,71,289,290,290,290,291,353,354,357,71,71,71,71,289,290,291,71,71,0,0,71,71,71,71,71,71,71,71,0,0,71,289,290,290,291,71,0,0,353,354,355,356,357,71,71,71,71,0,0,289,290,290,290,291,353,354,357,71,71,71,71,289,290,291,71,71,71,71,71,71,71,71,71,71,71,71,71,71,71,289,290,290,291,71,71,71,353,354,355,356,357,71,71,71,71,71,71,289,290,290,290,291,353,354,357,71,71,71,71,289,290,291,71,71,71,71,71,71,71,71,71,71,71,71,0,0,0,0,290,290,0,0,0,0,353,354,355,356,0,0,0,0,0,71,71,0,0,0,0,291,353,354,357,0,0,71,71,289,290,291,71,71,71,71,71,71,71,71,71,0,0,0,0,0,0,0,0,0,0,0,71,71,353,354,355,356,357,71,0,71,71,71,3,37,39,3,37,291,353,354,357,
0,0,0,0,0,0,0,0,0,0,0,0,0,0,0,0,0,0,0,0,0,0,0,0,0,0,0,0,0,0,0,0,0,0,0,0,0,0,0,0,0,0,0,0,0,0,0,0,0,0,0,0,0,0,0,0,0,0,0,0,0,0,0,0,0,0,0,0,0,71,71,0,0,0,0,0,0,0,0,0,0,0,0,0,0,0,71,71,71,0,0,0,0,0,0,0,0,0,0,0,0,0,0,0,0,0,0,0,0,0,0,0,0,0,0,0,0,0,0,0,0,0,0,0,0,0,0,0,0,0,0,0,0,0,0,0,0,0,0,0,0,0,0,0,0,0,0,0,0,0,0,0,0,71,71,0,0,0,0,0,0,0,0,0,0,0,0,0,0,0,0,0,0,0,0,0,0,0,0,0,0,0,0,0,0,0,0,0,0,0,0,0,0,0,0,0,0,0,0,0,0,0,0,0,0,0,0,0,0,0,0,
0,0,0,0,0,0,0,0,0,0,0,0,0,0,0,0,0,0,0,0,0,0,0,0,0,0,0,0,0,0,0,0,0,0,0,0,0,0,0,0,0,0,0,0,0,0,0,0,0,0,0,0,0,0,0,0,0,0,0,0,0,0,0,0,0,0,0,0,0,71,71,0,0,0,0,0,0,0,0,0,0,0,0,0,0,0,71,71,71,0,0,0,0,0,0,0,0,0,0,0,0,0,0,0,0,0,0,0,0,0,0,0,0,0,0,0,0,0,0,0,0,0,0,0,0,0,0,0,0,0,0,0,0,0,0,0,0,0,0,0,0,0,0,0,0,0,0,0,0,0,0,0,0,71,71,0,0,0,0,0,0,0,0,0,0,0,0,0,0,0,0,0,0,0,0,0,0,0,0,0,0,0,0,0,0,0,0,0,0,0,0,0,0,0,0,0,0,0,0,0,0,0,0,0,0,0,0,0,0,0,0